earn - зарабатывать
eat - есть
drink - пить
cry - плакать
smile - улыбаться
laugh - смеяться
enjoy - наслаждаться
doubt - сомневаться
hurt - делать больно
offend - обижать
see - видеть
look - смотреть
listen - слушать
hear - слышать
feel - чувствовать
remember - помнить
forget - забывать
recognize - узнавать
read - читать
write - писать
count - считать
add - прибавлять, добавлять
subtract - вычитать
multiply - умножать
divide - делить
think - думать
decide - решать 
do - делать
make - делать
perform - выполнять
prepare - готовить
hide - прятать
search - искать
ﬁnd - находить
ﬁll - наполнять
reduce - сокращать
exclude - исключать
spend - тратить
spoil - портить
remain - оставаться
keep - удерживать, держать
possess - владеть
belong - принадлежать
take - брать, занимать (время).
push - толкать
pull - тянуть
throw - бросать
open - открывать
shut - закрывать
cut - резать
pour - лить
dry - сушить
begin - начинать(ся)
appear - появляться
continue - продолжать(ся)
speak - говорить
talk - говорить
say - сказать
tell - сказать
address - обращаться
ask - спрашивать / просить
answer - отвечать
allow - разрешать
prohibit - запрещать
advise - советовать
warn - предупреждать
suggest - предлагать
give - давать
offer - предлагать
buy - покупать
sell - продавать
borrow - брать взаймы
lend - одолжить
introduce - представлять
disturb - мешать / беспокоить
forgive - прощать
apologize - извиняться
attack - нападать
fight - сражаться
defend - защищать
win - победить /выиграть
lose - проигрывать
shoot - стрелять
kill - убить
wound - ранить 


2. Прилагательные
red - красный
orange - оранжевый
yellow - желтый
green - зеленый
blue - синий
violet - фиолетовый
black - черный
white - белый
brown - коричневый
grey - серый
dark - темный
light - светлый
bright - яркий
pale - бледный
flat - плоский
straight - прямой
curved - кривой
square - квадратный
oval - овальный
round - круглый
sweet - сладкий
strong - крепкий
spicy - острый
loud - громкий
quiet - тихий
noisy - шумный
sharp - резкий
pleasant - приятный
aromatic - ароматный
specific - специфический
smelly - неприятно пахнущий
long - долгий
short - короткий
fast - быстрый
quick - быстрый
slow - медленный
early - ранний
late - поздний
old - старый
new - новый
young - молодой
adult - взрослый
ancient - древний
past - прошлый
present - настоящий
future - будущий
previous - предыдущий
recent - недавний
next - следующий
following - следующий
constant - постоянный
continuous - длящийся
uninterrupted - непрерывный
infrequent - нечастый
frequent - частый
sudden - внезапный
urgent - срочный
usual - обычный
calm - спокойный
angry - злой
sad - печальный
lonely - одинокий
happy - счастливый
good - хороший
bad - плохой
interesting - интересный
boring - надоедливый
pleasant - приятный
unpleasant - неприятный
excellent - отличный
perfect - совершенный
abominable - отвратительный
beautiful - красивый
nice - милый
attractive - привлекательный
kind - добрый
hostile - враждебный
gentle - вежливый
polite - вежливый
rude - грубый
generous - щедрый
excited - взволнованный
frightened - испуганный
astonished - удивленный
angry - сердитый
sensitive - чувствительный
indifferent - безразличный
hard-hearted - черствый
good-hearted - добросердечный
decent - приличный
honest - честный
fair - честный /справедливый
sincere - искренний
dishonest - нечестный
innocent - невиновный
guilty - виновный
criminal - преступный
talkative - разговорчивый
sociable - общительный
disobedient - непослушный
strict - строгий
mild - мягкий
reliable - надежный
brave - храбрый
reasonable - разумный
cautious - осторожный
clever - умный
intelligent - умный, знающий
talented - талантливый
silly - глупый
stupid - глупый, тупой
mad - сумасшедший
crazy - сумасшедший / чокнутый
diligent - прилежный / усердный
lazy - ленивый
high-quality - качественный
similar - похожий
different - различный
the same - тот же самый
main - главный
important - важный
insignificant - незначительный
necessary - необходимый
possible - возможный
desirable - желательный
occasional - случайный 
correct - правильный
wrong - неправильный
absurd - абсурдный
legal - законный
illegal - незаконный
standard - стандартный
suitable - подходящий
appropriate - подходящий
acceptable - приемлемый
satisfactory - удовлетворительный
advantageous - выгодный
disadvantageous - невыгодный
useful - полезный
useless - бесполезный
harmful - вредный
harmless - безвредный
cheap - дешевый
expensive - дорогой
free of charge - бесплатный
healthy - здоровый
sick - больной
ill - больной
strong - сильный
weak - слабый
tired - усталый
rich - богатый
рооr - бедный
ready - готовый
convenient - удобный
comfortable - удобный
free - свободный
vacant - свободный / вакантный
busy - занятый (чем-либо)
occupied - занятый (о месте)
clean - чистый
dirty - грязный
hungry - голодный
thirsty - жаждущий 
average - средний
sufficient - достаточный
full - полный 

3. Существительные


weather - погода
season - сезон
north - север
winter - зима
spring - весна
summer - лето
autumn - осень
temperature - температура
pressure - давление
rain - дождь
snow - снег
thunder - гром
lightning - молния
wind - ветер
hour - час
minute - минута
clock - часы
watch - часы
calendar - календарь
morning - утро
midday - полдень
noon - полдень
afternoon - время после обеда
evening - вечер
night - ночь
present - настоящее
past - прошлое
future - будущее
beginning - начало
end - конец
schedule - расписание
delay - задержка
holiday - праздник /каникулы
weekend - выходные дни
vacation - каникулы
human being - человек
man - мужчина
woman - женщина
child - ребенок
girl - девочка
boy - мальчик
youth - юность, молодость
grown-up - взрослый (человек)
nationality - национальность 
body - тело
weight - вес
bone - кость
muscle - мышцы
blood - кровь
skin - кожа
hair - волосы  
Части тела
head - голова
neck - шея
chest - грудь
back - спина
stomach - живот
leg - нога
foot - стопа
arm - рука
hand - кисть
finger - палец
elbow - локоть
knee - колено
waist - талия
heel - пятка
nail - ноготь
face - лицо
eye - глаз
ear - ухо
forehead - лоб
cheek - щека
mouth - рот
lip - губа
tooth - зуб
tongue - язык
nose - нос
eyebrow - бровь
eyelash - ресница
skull - череп
chin - подбородок
temple - висок
brain - мозг
lungs - легкие
heart - сердце
stomach - желудок
liver - печень
kidney - почка
family - семья
father - отец
mother - мать
child - ребенок
sister - сестра
brother - брат
husband - муж
wife - жена
son - сын
daughter - дочь
wedding - свадьба
divorce - развод
parents - родители
relatives - родные
grandfather - дедушка
grandmother - бабушка
uncle - дядя
aunt - тетя
nephew - племянник
niece - племянница
cousin - двоюродный брат /сестра
grandson - внук
granddaughter - внучка
relations - отношение, связь
friend - друг
colleague - коллега
employer - работодатель
employee - наемный работник
acquaintance - знакомство 
address - адрес
house - дом
building - здание
street - улица
square - площадь
apartment - квартира
flat - квартира
floor - этаж
yard - двор
fence - забор  
roof - крыша
wall - стена
floor - пол
ceiling - потолок
window - окно
corner - угол
staircase - лестница
landing - лестничная площадка
lift - лифт
door - дверь
bell - звонок
lock - замок
кеу - ключ
room - комната
entrance hall - прихожая
kitchen - кухня
bathroom - ванная
toilet - туалет
bedroom - спальня
furniture - мебель
table - стол
chair - стул
armchair - кресло
bed - кровать
sofa - диван
carpet - ковер
mirror - зеркало
fridge - холодильник
vacuum cleaner - пылесос
washing machine - стиральная машина
stove - плита
iron - утюг
meals - пища, еда
breakfast - завтрак
lunch - второй завтрак /обед
dinner - обед
supper - ужин
appetite - аппетит 
drink - напиток
tea - чай
coffee - кофе
milk - молоко
juice - сок
wine - вино
sweets - сладости
chocolate - шоколад
biscuit - печенье
cake - торт /пирожное
pie - пирог
jam - варенье
sugar - caxap
honey - мёд 
butcher’s - мясной магазин
greengrocer’s - овощной магазин
dairy - молочный магазин
sausage - колбаса
cheese - сыр
fish - рыба
canned goods - консервы
butter - сливочное масло
bread - хлеб
emotion - эмоция
feeling - чувство
pleasure - удовольствие
satisfaction - удовлетворение
happiness - счастье
joy - радость
sadness - печаль
excitement - возбуждение
suffering - страдание
sympathy - сочувствие
admiration - восхищение
respect - уважение
love - любовь
friendship - дружба
envy - зависть
wish - желание
intention - намерение
dream - мечта
hope - надежда
purpose - цель
information - информация
report - сообщение /доклад
news - новости
rumour - слух, молва
truth - правда
lie - ложь
language - язык
word - слово
foreign language - иностранный язык
mother tongue - родной язык
sentence - предложение
phrase - словосочетание
meaning - значение/смысл
pronunciation - произношение
stress - ударение
accent - ударение
conversation - беседа
question - вопрос
answer - ответ
advice - совет
warning - предупреждение
request - просьба
demand - требование
promise - обещание
remark - замечание
help - помощь
assistance - помощь 
etiquette - этикет
behaviour - поведение
politeness - вежливость
apology - извинение
forgiveness - прощение
attitude - отношение
city - город
town - маленький город
street - улица
square - площадь
building - здание
bus - автобус
trolleybus - троллейбус
tram - трамвай
metro - метро
car - автомобиль
taxi - такси
truck - грузовик
platform - платформа
track - путь
train - поезд
departure - отправление
arrival - прибытие
change - пересадка
airport - аэропорт
plane - самолет
check in - регистрация
passport control - паспортный контроль
take-off - взлет
landing - посадка
flight attendant - стюардесса
pilot - пилот
boarding - посадка на борт
flight - полет
seat - место
seat-belt - ремень безопасности
hotel - отель
police - полиция
hospital - больница
church - церковь
market - рынок
restaurant - ресторан
circus - цирк
theatre - театр
cinema - кинотеатр
health - здоровье
hygiene - гигиена
illness - болезнь
disease - болезнь
recovery - выздоровление
death - смерть
injury - повреждение
fracture - перелом
wound - рана
burn - ожог
allergy - аллергия
shop - магазин
goods - товары
laundry - прачечная
hotel - гостиница
reservation - бронирование
room - номер
bill - счет
profession - профессия
doctor - врач
teacher - учитель
lawyer - юрист
businessman - бизнесмен
engineer - инженер
worker - рабочий
officer - офицер, полицейский
soldier - солдат   

4. Наречия
когда - when 
почему - why
back - назад
up - вверх
down - вниз
sideways - в сторону
around  вокруг - 
now - сейчас
lately - в последнее время
recently - недавно
just - только что
already - уже
yet - уже
always - всегда
often - часто
frequently - часто 
constantly - постоянно 
usually - обычно
seldom - редко
sometimes - иногда 
never - никогда 
however однако - 
nevertheless тем не менее - 
meanwhile тем временем - 
otherwise в противном случае - 
absolutely	совершенно; безусловно	
actually	на самом деле, в действительности	
badly	скверно, дурно, плохо	
bravely	смело	
bright(ly)	ярко	
fast быстро	
finally	в конечном счёте, в конце концов	
firstly	во-первых	
calmly	спокойно, хладнокровно, невозмутимо	
carefullyтщательно, внимательно
cheap(ly)	дешево	
clearly	ясно; очевидно; несомненно
completely	вполне, всецело, полностью	
daily	ежедневно, каждый день
decidedly	определённо; решительно, 
deeply	глубоко
definitely	определённо, точно, явно	
easily	легко; свободно, без труда
especially	особенно, главным образом	
exactly	в точности; как раз; ровно	
extremely	чрезвычайно, крайне; очень	
fast	быстро	
finally	в конечном счёте, в конце концов	
firstly	во-первых	
fortunately	счастливо, к счастью	
frequently	часто	
fully	вполне, полностью, совершенно	
gently	мягко, нежно, кротко	
gratefully	с благодарностью, благодарно	
happily	успешно; к счастью; с удовольствием	
hard	усердно, настойчиво, упорно	
hardly	едва, еле	
heavily	тяжело; сильно, интенсивно
honestly	честно; искренне, правдиво
hopelessly	безнадёжно	
immediately	непосредственно; немедленно, сразу	
incredibly	неправдоподобно, 
loudly 	громким голосом, громко
monthly ежемесячно; раз в месяц
nearly почти; приблизительно
noisily шумно, громко
obviously явно, заметно; очевидно
perfectly совершенно; отлично, прекрасно
politely вежливо, любезно
probably вероятно, наверное
properly должным образом; как следует; правильно
quickly быстро, скоро, поспешно
quietly спокойно, тихо, бесшумно
rapidly быстро
rarely 	редко, нечасто
really действительно, в самом деле
recently 	недавно; в последнее время
regularly регулярно, постоянно
repeatedly часто, неоднократно
roughly приблизительно, ориентировочно
separately	отдельно, порознь
seriously (говоря) серьёзно
slightly незначительно, слегка
slowly медленно
straight прямо, по прямой линии
suddenly вдруг, внезапно, неожиданно
tightly	плотно, туго
totally полностью; совершенно
truly	правдиво; искренне
unfortunately	к несчастью, к сожалению
weekly	еженедельно; раз в неделю
well	хорошо
yearly	каждый год, ежегодно
also - также
accidentally - случайно 
arrogantly - высокомерно
beautifully - красиво
blissfully - блаженно
boastfully - хвастливо
broadly - широко
cautiously - осторожно
cleverly - умно
courageously - смело
daintily  - изящно
defiantly - вызывающе
doubtfully - сомнительно
dreamily - мечтательно
energetically - энергично
enthusiastically- с энтузиазмом
equally - одинаково
eventually - в конце концов
excitedly - взволнованно
fondly - нежно
foolishly - глупо
greedily - жадно
justly - справедливо
lazily - лениво
loosely - свободно
occasionally - изредка
thus - таким образом
very - сильно, интенсивно
warmly - тепло
yesterday - вчера


